

NO ./textures/color_stone.xpm
SO ./textures/color_stone.xpm
WE ./textures/eagle.xpm
EA ./textures/mossy.xpm

F 255,255,255
C 99,184,255

1111111111111
10000000011000000000000001
10100S00001000000000000001
10010000001000000000000001
100000100010000000000000001
100000000000000000000000001
11111111111









