
	               
NO ./textures/gentle_mates2.xpm
SO ./textures/color_stone.xpm
WE ./textures/grey_stone.xpm
EA ./textures/eagle.xpm

F 114,96,84
C 99,184,255

1111111
1000001
100000111
10000N001
1111111
