

NO ./textures/color_stone.xpm
SO ./textures/color_stone.xpm
WE ./textures/eagle.xpm
EA ./textures/mossy.xpm

F 255,255,255
C 99,184,255

11111111111
10000000011
10100S00001
10000000001
10000000001
11111111111









