

NO ./textures/color_stone.xpm
SO ./textures/color_stone.xpm
WE ./textures/eagle.xpm
EA ./textures/mossy.xpm

F 255,255,255
C 99,184,255

1111111111
1000000001
1010S00001
1001000001
1000001001
1000000001
1000010001
1000000001
1000110001
1111111111
